W             -- Activate Surfraw defined web-browser
alioth        -- Search Alioth (alioth.debian.org)
altavista     -- Search the web using Altavista (www.altavista.com)
amazon        -- Search the amazon.com bookstore
appwatch      -- Search entries on Appwatch (www.appwatch.com)
ask           -- Question the web using Ask Jeeves (www.ask.com)
austlii       -- Search Australian Law docs (www.austlii.edu.au)
bbcnews       -- Search BBC News (news.bbc.co.uk)
britannica    -- Look up word in Encyclopedia Britannica (www.britannica.com)
cddb          -- Search for cd track listings in CDDB (www.gracenote.com)
cite          -- Search computer science papers (www.researchindex.com)
cnn           -- Search on CNN (cnn.com)
currency      -- Abuse the Universal Currency Converter (www.xe.net/ucc)
debbugs       -- Search the debian BTS (bugs.debian.org)
debcontents   -- Search contents of debian packages(packages.debian.org)
debpackages   -- Search debian packages (packages.debian.org)
deja          -- Search usenet using Deja News (www.dejanews.com)
excite        -- Search on Excite (www.excite.com)
fast          -- Search the web using FAST Search (www.alltheweb.com)
filesearching -- Search files on filesearching (www.filesearching.com)
freebsd       -- Search FreeBSD related information (www.freebsd.org)
freedb        -- Search for cd track listings in FreeDB (www.freedb.org)
freshmeat     -- Search Freshmeat (www.freshmeat.net)
ftpfind       -- Search files on ftpfind (www.ftpfind.com)
ftpsearch     -- Search files on ftpsearch (ftpsearch.lycos.com)
google        -- Search the web using Google (www.google.com)
imdb          -- Search the Internet Movie Database (www.imdb.com)
jake          -- Search journal/databases in jake (jake.med.yale.edu)
netbsd        -- Search NetBSD related information (www.netbsd.org)
openbsd       -- Search OpenBSD related information (www.openbsd.org)
pubmed        -- Search medical/molbio databases (www.ncbi.nlm.nih.gov)
raging        -- Search the web using Raging (www.raging.com)
rhyme         -- Search for rhymes et al using Lycos Rhyme (rhyme.lycos.com)
scaleplus     -- Search Australian Law using ScalePlus (scaleplus.law.gov.au)
slashdot      -- Search stories on Slashdot (www.slashdot.org)
slinuxdoc     -- Search entries in LDP (www.linuxdoc.org)
sourceforge   -- Search SourceForge (www.sourceforge.net)
stockquote    -- Get a single stock quote (multiple providers)
sundocs       -- Search docs on Sun.com (docs.sun.com)
sunsolve      -- Search public docs on Sunsolve (sunsolve.sun.com)
swhois        -- Search Whois (www.geektools.com)
thesaurus     -- Look up word in Merriam-Webster's Thesaurus (www.m-w.com)
translate     -- Translate human languages (various providers)
webster       -- Look up word in Merriam-Webster's Dictionary (www.m-w.com)
wetandwild    -- Real time weather information (many sources)
woffle        -- Search the web using wwwoffle (localhost:8080)
xxx           -- Superior XXX, hot and ready to press (arXiv.org)
yahoo         -- Search Yahoo categories (www.yahoo.com)
